type octile
height 64
width 64
map
TTTTTTTTT........WWWWWWWWWWWWWWWWWWWWWWWWWWWWWWWWTTTTTTTTTTTTTTW
TTTTTTTTT........WWWWWWWWWWWWWWWWWWWWWWWWWWWWWWWWTTTTTTTTTTTTTWW
TTTTTTTTT........WWWWWWWWWWWWWWWWWWWWWWWWWWWWWWWWWTTTTTTTTTTTWWW
TTTTTTTTT........WWWWWWWWWWWWWWWWWWWWWWWWWWWWWWWWWWTTTTTTTTTWWWW
TTTTTTTT........WWWWWWWWWWWWWWWWWWWWWWWWWWWWWWWWWWWTTTTTTTTWWWWW
TTTTTTT.........WWWWWWWWWWWWWWWWWWWWWWWWWWWWWWWWWWWTTTTTTTTWWWWW
TTTTTT.........WWWWWWWWWWWWWWWWWWWWWWWWWWWWWWWWWWWWWTTTTTTTWWWWW
TTT...........WWWWWWWWWWWWWWWWWWWWWWWWWWWWWWWWWWWWWWWTTTTTWWWWWW
TT...........WWWWWWWWWWWWWWWWWWWWWWWWWWWWWWWWWWWWWWWWWWWWWWWWWWW
T...........WWWWWWWWWWWWWWWWWWWWWWWWW.....WWWWWWWWWWWWWWWWWWWWWW
...........WWWWWWWWWWWWWWWWW................WWWWWWWWWWWWWWWWWWWW
..........WWWWWWWWWWWWWWW.....................WWWWWWWWWWWWWWWWWW
.........WWWWWWWWWWWWWWW........................WWWWWW....WWWWWW
.........WWWWWWWWWWWWWW.........TT............TT.............WWW
........WWWWWWWWWWTTWW..........TT............TT...............W
........WWWWWWWWWTTTT...................TT......................
T.......WWWWWWWWTTTTT....TT.............TT..........TTT...TTTT..
TT......WWWWWWWTTTTTT....TT.........................TTT...TTTT..
TT......WWWWWWWTTTTTT...............................TTT...TTTT..
TT........WWWWWTTTTTT............TT.......................TTTT..
TT.........WWWWTTTTTTT...........TT.......................TTTT..
TTT........WWWWWTTTTTT................WWW.......TTTTTTT...TTTT..
TTT........WWWWWWWWTT................WWWWWWW....T.....T...TTTT..
TTT........WWWWWWWWWWW..............WWWWWWWWWWW.......T...TTTT..
TT.........WWWWWWWWWWWWW............WWWWWWWWWWWWT.....T...TTTT..
...........WWWWWWWWWWWWWWWW.T..T..WWWWWWWWWWWWWWT.....T.........
..........WWWWWWWWWWWWWWWWWWT..TWWWWWWWWWWWWWWWWTTT.TTT.........
..........WWWWWWWWWWWWWWWWWWT..TWWWWWWWWWWWWWWWWWW..............
WWW......WWWWTTTTTWWWWWWWWWWT..TWWWWWWWWWWWWWWWWWW..............
WWWWW...WWWWWTTTTTTWWWWWWWWWT..TWWWWWWWWWWWWWWWWWWW.............
WWWWWWWWWWWWTTTTTTTTWWWWWWW.T..T..WWWWWWWWWWWWWWWWWW............
WWWWWWWWWWWTTTTTTTTTWWWWWW..........WWWWWWWWWWWWWWWW............
WWWWWWWWWWWTTTTTTTTTWWWWWW...........WWWWWWWWWWWWWWW..........TT
WWWWWWWWWWWTTTTTTTTTWWWWWW............WWWWWWWWWWWWW..........TTT
WWWWWWWWWWWWTTTTTTTTWWWWWW.............WWWWWWWWWWWW.........TTTT
WWWWWWWWWWWWWWTTTTTWWWWWWW.............WWWWWWWWWW..........TTTTT
WWWWWWWWWWWWWWWWWWWWWWWWWW..............TTTWWWWW..........TTTTTT
WWWWWWWWWWWWWWWWWWWWWWWWWW.............TTTTTTW............TTTTTT
WWWWWWWWWWWWWWWWWWWWWWWWW.............TTTTTTT......TT.....TTTTTT
WWWWWWWWWWWWWWWWWWWWWWW..............TTTTTTTTT....TTTT....TTTTTT
WWWWWWWWWWWWW.......................TTTTTTTTTTT...TTTT....TTTTTT
WWWWWWWWWWWW........................TTT...T...T....TT.....TTTTTT
WWWWWWWWWWW..........................TT.T.TTT.T............TTTTT
WWWWWWWWWWW.............................T.T...T............TTTTT
WWWWWWWWWW....TTTTT..................TTTT.T.TTTT............TTTT
WWWWWWWWWW....TTTTT.................TTT...T.................WWTT
WWWWWWWWWW....TTTTT.................TTT.TTT.TTTT.....TT....WWWWW
WWWWWWWWWW....TTTTT..TTTTT..........TTT...T.TTT.....TTTT..WWWWWW
WWWWWWWWWW....TTTTT..TTTTT...........TT.TTT.TT......TTTT..WWWWWW
WWWWWWWWWW...........TTTTT...........TT.....TT.......TT...WWWWWW
WWWWWWWWWWW..........TTTTT............TTTTTTTT............WWWWWW
WWWWWWWWWWWW....................WW.....TTTTTTW...........WWWWWWW
WWWWWWWTTWWWW..................WWWWWW..TTTTWWWW.........WWWWWWWW
WWWWWWTTTTWWWW................WWWWWWWWWWWWWWWWWWWWWWWWWWWWWWWWWW
WWWWWWTTTTTWWWWWWWW.........WWWWWWWWWWWWWWWWWWWWWWWWWWWWWWWWWWWW
WWWWWWWTTTTTWWWWWWWWWWWWWWWWWWWWWWWWWWWWWWWWWWWWWWWWWWWWWWWWWWWW
WWWWWWWWTTTTTWWWWWWWWWWWWWWWWWWWWWWWWWWWWWWWWWWWWWWWWWWWWWWWWWWW
WWWWWWWWWTTTTTWWWWWWWWWWWWWWWWWWWWWWWWWWWWWWWWWWWWWWWWWWWWWWWWWW
WWWWWWWWWWWTTWWWWWWWWWWWWWWWWWWWWWWWWWWWWWWWWWWWWWWWWWWWWWWTTTTW
WWWWWWWWWWWWWWWWWWWWWWWWWWWWWWWWWWWWWWWWWWWWWWWWWWWWWWWWWWTTTTTT
WWWWWWWWWWWWWWWWWWWWWWWWWWWWWWWWWWWWWWWWWWWWWWWWWWWWWWWWWTTTTTTT
WWWWWWWWWWWWWWWWWWWWWWWWWWWWWWWWWWWWWWWWWWWWWWWWWWWWWWWWTTTTTTTT
WWWWWWWWWWWWWWWWWWWWWWWWWWWWWWWWWWWWWWWWWWWWWWWWWWWWWWTTTTTTTTTT
WWWWWWWWWWWWWWWWWWWWWWWWWWWWWWWWWWWWWWWWWWWWWWWWWWWWWTTTTTTTTTTT